
NO      ./textures/wall-NO.xpm

SO ./textures/wall-SO.xpm




    F    160,170,145

   C    25,25,25

EA ./textures/wall-EA.xpm

WE ./textures/wall-WE.xpm

        1111111111111111111111111
        1000000000110010010010001
        1011000001110000000000001
        100100000000W000000000001
111111111011000001110001100011001
100000000011000001110111110111111
11110111111111011111000010001
   101       101   1010010001
1111011111 111011111010010011
11000000111101011100000010001
10010000000000000000000000001
10000000100000001101010010001
1101010111110111111101111000111
10000001 1000001 100011000001
11111111 1111111 111111111111